NO ./path.xpm
SO ./path.xpm
WE ./path.xpm
EA ./path.xpm

F 0,0,0
C 255,255,255

11111
1N001
10 01
10001
11011
