NO ./xpm.xpm
SO ./xpm.xpm
WE ./xpm.xpm
EA ./xpm.xpm

F 10,10,10
C 250,250,250

11111
1N0E1
10001
10001
11111
