NO ./textures/main/wall_1.xpm
WE ./textures/main/wall_1.xpm
SO ./textures/main/wall_1.xpm
EA ./textures/main/wall_1.xpm


C 5,6,7
F 30,31,32

1111111111111111111111111111111111111111111111111111
1000000000000000000000000000000000000000000000000001
1011111111110111111111101111111111111110111111111101
1010000000010100000000100000000000000010100000000101
1010111111010111111111111111111111111010111111110101
10101000010100000000000000000000000010100000D0101001
1010101111010111110E11111110111111111111101111101011
1010000000010100010000000000000010000010100000100011
1011111111010111111110111110111111111010111111101111
1000000001010000000010100000100000001010000000000001
1011111101110111111010111010111111111011111111111011
1010000100000100000010000000100000001000000000001011
1010100111111110111111110111110111111010111011111011
1010100100000000100000000100000100000010100000000001
1010101110111110111111010111110111111010111110111011
1010100000100010100000000100000000100010100010100001
1010111111111010111111110111111110111110101010111111
1010000000000000000000000000000000000000000000000001
1111111111111111111111111111111111111111111111111111