NO ./textures/north.xpm
SO ./textures/south.xpm
WE ./textures/west.xpm
EA ./textures/east.xpm

F 120,100,100
C 50,100,150

11111
1N001
10001
10001
11111
