NO ./path.xpm
SO ./path.xpm
WE ./path.xpm
EA ./path.xpm

F 0,255,0
C 0,0,255

  1111111
  1N0  01
111  0 1
1     01
11111111
