NO ./textures/wall_4.xpm
WE ./textures/wall_3.xpm
SO ./textures/wall_2.xpm
EA ./textures/wall_1.xpm

F 0,255,0
C 0,0,255

111111
1E0001
102201
103301
100001
111111