NO ./textures/wall_4.xpm
WE ./textures/wall_3.xpm
SO ./textures/wall_2.xpm
EA ./textures/wall_1.xpm

F 100,100,0
C 0,0,0

1111111111
1W00000001
1011111101
1000000001
1111111111
