NO ./n.xpm
SO ./s.xpm
WE ./w.xpm
EA ./e.xpm

F 100,100,0
C 0,0,0

1111111111
1N00000001
1011111101
1000000001
1111111111
