C     0,255,255  
F     10,0,94

F 0,255,0
C 0,0,255,2134, 1234, 123 12

EA                          ./textures/wall_2.xpm
SO             ./textures/wall_3.xpm
NO                ./textures/wall_1.xpm
WE ./textures/wall_4.xpm 



1111111 
1N10001
1110001
1100001
1111111
